E E E E E E E E E E E E E E E E
K K K K K K K K K K K K K K K K
J J J J J J J J J J J J J J J J
I I I I I I I I I I I I I I I I
H H H H H H H H H H H H H H H H
E E E E E E E E E E E E E E E E
K K K K K K K K K K K K K K K K
J J J J J J J J J J J J J J J J
I I I I I I I I I I I I I I I I
H H H H H H H H H H H H H H H H
E E E E E E E E E E E E E E E E
K K K K K K K K K K K K K K K K
J J J J J J J J J J J J J J J J
I I I I I I I I I I I I I I I I